GGGGGGGGGGGGGGGGGGGGGGGGGGG
GGGGGGGGGGGGGGGGGGGGGGGGGGG
GGGGGGGGGGGGGGGGGGGGGGGGGGG
GGGGGGGGGGGGGGGGGGGGGGGGGGG
GGGGGGGGGGGGGGGGGGGGGGGGGGG
KKKKKKKKKKKKKKKKKKKKKKKKKKK
^^^^^^^^^^^^^^^^^^^^^^^^^^^
^^^^^^^^^^^^^^^^^^^^^^^^^^^
^^^^^^^^^^^^^^^^^^^^^^^^^^^
^^^^^^^^^^^^^^^^^^^^^^^^^^^
^^^^^^^^^^^^^^^^^^^^G^^^^^^
^S^^^^G^^^^^^^^^^^^^^^^^^^^
LLCRRRCLCRRB^^^TLLCRRCLCRCL
GGGGGGGGGGGE^^^WGGGGGGGGGGG
GGGGGGGGGGGE^^^WGGGGGGGGGGG